NO ./png/stone_xpm/42/42_4.xpm
SO ./png/stone_xpm/stone3.xpm
WE ./png/stone_xpm/42/42_3.xpm
EA ./png/stone_xpm/42/42_1.xpm

C 0,50,100
F 100,100,100

        1111111111111111111111111
        1000000000110000000000001
        1011000001110000010000001
        10010000000000001 1000001
111111111011C00010110000010000001
100000000011000101010001111111111
11110111111111001000000010001
11110111111111011101010000001   1
110000C0110101011100001000001  1
10C000C0C00000001100000010001
10C000N0000000001101010010001
1100000111010101111101111000111
11110111 1110101 101111010001
11111111 1111111 111111111111
